NO ./textures/rays.png
SO ./textures/rays.png
WE ./textures/rays.png
EA ./textures/rays.png

F 0,110,180,40
C 0,0,0,30

        1111111111111111111111111
        1000000001110000000000001
        1011000001110000000000001
        1001000000000000000000001
111111111011000001110000000000001
100000000011000001110111111111111
11110111111111011100000010001
11110111111111011101010010001
11000000110101011100000010001
1W000000000000002000000000001
10000000000000001101010012221
100000111010101111101111000111
1201111 1000001 1000000000001
1021111 1000001 1000000000001
1201111 1000001 1000000000001
1021111 1000001 1000000000001
1201111 1000001 1000000000001
1F110111 1110101 101111010001
11111111 1111111 111111111111