NO ./textures/rays.png
SO ./textures/minecraft.png
WE ./textures/minecraft.png
EA ./textures/rays.png

C 0,0,0,0
F 69,24,4

1111111111111111111111111
1000000001110000000000001
10110000011N0000000F00000
1001000000000000000000001
1111110110020011100000001
1000000110000011101111111
1111111111111111111111111