NO ./textures/asteroids.png
SO ./textures/asteroids.png
WE ./textures/asteroids.png
EA ./textures/asteroids.png

C 255,30,0
F 220,100,0

1111111111111111111111111
1000000001110000000000001
10110000011N0000000F00001
1001000000000000000000001
1111110110000011100000001
1000000110000011101111111
1111011111111101110000001
1111011111111101110101001
1100000011010101110000001
1000000000000000110000001
1000000000000000110101001
1100000111010101111101111
1111011111110101101110101
1000000011111000000000001
1011111011111011111101111
1000000000000010000100001
1111111111111111110000001
1000000011111000000000001
1011111011111011111101111
1000000000000010000100001
1111111111111111110000011
1000000000000000000000001
1111111111111111111111111
